99999999999999999999999999999999999999999999999999999999999999999999999999999999999999999999999999999999999999999999999999999999999999999999999999999999999999999999999999999999999999999999999999999999
99999999999999999999999999999999999999999999999999999999999999999999999999999999999999999999999999999999999999999999999999999999999999999999999999999999999999999999999999999999999999999999999999999999
99999966666999999999999999999999999999999999999999999999999999999999999999999999999999999999999999999999999999999999999999999999999999999999999999999999999999999999999999999999999999999999969999999999
99996666666699999999999999999999999999999999999999999999999999999999999999999999999999999999999999999999999999999999999999999999999999999999999999999999999999999999999999999999999999999999969999999999
99996666666699999999999999999999999999999999999999999999999999999999999999999999999999999999999999999999999999999999999999999999999999999999999999999999999999999999999999999999999999999999969999999999
99999666666699999999999999999999999999999999999999999999999999999999999999966666666699999999999999999999999999999999999999999999666669999999999999966666666666666669999999999999999999999999999999999999
99999999999999999999999999999999999999999999999999999999999999999999999999996666666666999999999999999999999999999999999999999999669966999999999999666666666666666699999999999999999999999999999999999999
99999999999999999999999999999999999999999999999999999999999999999999999996666666666666999999999999999999999999999999999999999666666999999999999669969999996666666666999999999999999999999999999999999999
99999999999999999999999999999999999999999999999999999999999999999999999996666666666666999999999999999999999999999666666666666666699999999999999669669999999966666666699999999999999999999999999999999999
99999999999999999999999999999999999999999999999999999999999999999999999999999996666669999999999999999999999696666666666699999999969999999999969966699999999999996666669999999999999999999999999999999999
99999999999999999999999999999999999999999999999999999999999999999999999999999999996699999999999666666666666666669999999989999666666669999989666999999999999999999999999996666666666666666999999999999999
99999999999999999999999999999999999999999999999999999999999999999999999999999999999699999999996666666666666666999999969999996664444999999899996999446699999999999999999999996666666666669999999999999999
99999999999999999999999999999999999999999999999999999999999999999999999999999999999966666666666666666666669999999999969888899999469996998899999998966666666999999999999999999999996699999999999999999999
99999999999999999999999999999999999999999999999999999999999999999999999996969966699966666666666666666666665499699999999998899888899999989998889999999999999999999999999999999999999999999999999999999999
99999999999999999999999999999999999999999999999999999999999989999999999699999999999999996666666666666699659999996699998898888089999998966988988999999999999999999999999999999999999999999999699999999999
99999999999999999999999999999999999999999999999999999999999996966999999966699969899999965554666669433354699999999966669880088969699969999999999888999999999999999999999999999999999999999999969999999999
99999999999999999999999999999999999999999999999999999999999966699999999999999999999999964252266699996269999999999999889880888896666646669999666466699699999999999999999999999999999999999999669999999999
99999999999999999999999999999999999999999999999999999999999999999999999696666699999999999999999999999449999999998999669988899644444444446996644449999999999964699996666669999999999999999999966999999999
99999999999999999999999999999999666666666666699999999999999999999999999666666999999999999996699999999999999966666999999988669964446666666996644468888999999966699666666666699999999999999999966999999999
99999999999999999999999999999966666666666666669999999699999999999969999666666996999896696999999966669999999996666666996996996696699999999964444699999666989999696666666666699669999999999999999999999999
99999999999999999999999999996666666666666666666699999699999999899999999666666449999699999699999966666999999999999999996669999999999669696664669699699969999999999666666666666666999999999999999999999999
99999999999999999999999999966666666666966999996966999999999999999999999666964666699999996989999996644466999999999999999969999999966666699649999966666666699699996666666666666666669999999999999999999999
99999999999999999999999999996999999669999999999699999999969999999999999999999999999696666699969644469644466669666669999999999999666688698899999896696666969999999966666666666666666999999999999999999999
99999999999999999999999999999999999966699999996234998999999969999669899999998945569966666664664444666644449896446969999996699699669980890088896999666669966999664699666666666666666699999999999999999999
99999999999999999999999999999999999966669999943335998999996666696698889699964689699666646666466666999664696964466669699996666999969998800886644696666989999982322359666666666666666666669999999999999999
99999999999999999999999999999999999996666696224466998899969666669800086669959999966645666469999999999966444446669669996445555549966966980089880889666899996992333336666669666666666666666666666999999999
99999999999999999999999999999999999999669964699999999988996696998000089996969946669446966669696999999999664469996669699669669699999988088000086644469899999962224222696423124999999999966666666999999999
99999999999999999999999999999999999996454999999999666988899999669980088996699999666669996966999696699999966699996699999999996999964669998808999889469999999996699696444446644666666666996666666999999999
99999999999999999999999999999999999964212699966999999998999669969880089666666999999998999666998999999889999999999999966999969999696644466888896646699999888999999999996999666666669999999966666999999999
99999999999999999999999999999999996449988969999999999999899999666899998999999996696699996669999999990000999999999999969666666999966666644999989699999999999999999999666666666666666999999996666999999999
99999999999999999999999999999999642246999999999999999999998899999899699999966666669999666699999966980000999886669666669999669699666669966444999899999999999999999999666666666666666999999999966999999999
99999999999999999999999999999996566999999999999999999999999999999996669999644444699669966966669988998808999889999446669969969666999666699644669999899999999699999996666666666666669999999999989999999999
99999999999999999999999999998969889999999999989999999999999999899666666444444666999999996466946996699900008969666446666666699666669999999966669999999999999998999996666666669999699999999999999999999999
99999999999999999999999966998999999999999998999999999999999999996666444466996696999999996666966669880088800899996444669996999666669999999999999999666999999999999699666666999999999999999999999999999999
99999999999999999996999999698999999999998999666699988996669969996999669966999966669969699969686988800008808998996446966669966666469988999998999999969889969999999699666669999999999999999999999999999999
99999999999999999999999966688999999999999996666669980008969869999996696966699669996969999969998946998000089899666666669999999996669999899999996666999888889969699999999999966669999999999999666999999999
99999999999999969999696669999999999999999999666669888899666889996966666696669999999996696699999666446980088964466669996696999666666999999999966669999898899966699966666996666669995332999624699999999999
99999999999996999969999999999999969999999999669690000898089889999999666666999666666669666666666664444988889996669999699699969989669999999999999999999894689999999999669969969999995333222429669999999999
99999999999999969999899989966999699999996669666996988800889669969998999669969666644664469666466464469808886666696666696969966999899969999996999999998884398989999999966666666999999522566669666999999999
99999999999999669989988999999999999996666666666669988000889999996996996999669696644696466666999668998889669969999966999966966999989966999996999999989996699996699999996666699999996666696666699999999999
99999999999996446999988889999999999966666696944445698809996669999696996669966666966996966666666966899966969999996999669999964698999966699669999899999999988899996644466666699999996666666666999999999999
99999999999644469999988896996666666666999949994444469988896666666699666666969899999999666696666669996664669999996699666966994468999966699999999999996669989999994444446966669999999999669999999999999999
99999999999666666999899999666444444699999969998644446999886444449699966666699966999999966669996666699644466699699699666666664698999996969999999999996969999696644446666666669999999999999999999999999999
99999999999999999699999699996469966996696696669996444699964444446999999666999699999999969946699999669988889444699699999966666989699996999999998999999999996644444666996699999999999999999999999999999999
99999999669999999999999998994466669999666933546999446466444466669999996699666996999699666896669999888998009466669669999699996696666666999999999999999899664446669999996996689999999999999999999999999999
99999999999999999999999999666454669999988669696999466666644466669999999996646666444466699966699969980088008666666669996469999966666666999999999999999999664699999666999999966666449999999999999999999999
99999999999999969999999999996466669996996666666996466669666666669996996696664466666669999666696669988000008896464669944649999999666669996999999999999696699999999999999966696669669999999699999999999999
99999999969966666666699999999666999999999669999666666699666666999999996999996466996669999996696669888898009666666455466644699996669999966999996699969466666669996669999996699669999999999999999999999999
99999999966664446666669999966699966699966646646666669969999996699966996699666996999996696669999666666988088644666669666664699966999999999969964669996449996999999999996999966666666999999699999999999999
99999999999666666669999999996669999999966969696644669966699996669999966666669999996446646644646666669888886666666664466446999666699999966464446969669999666699996999969999966666996999999699999999999999
99999999999999999669999999966699999999969999996444669999666999999999999966669969895666666966646666666989999996666664446666699669669969966664696966866969666669999666699669666666666999999999999999999999
99999999999999999999966669999999999999999999996444666966999999999999999666666969995644446644664466666666666666666444469666999999966999999666696669996966999999996699666699666666666666999999999999999999
99999999999999999999999999999999999999999999999999699969999996996669996444446999999964444444966699999966666666644444999666999999999999999996666699896699999699999666666996666666666666669999999999999999
99999999999696666996669999999999999999999999999999999996996666966996999466996698889999664446466644444666444644664666999666999999966669968899669999966666669999946669966666666666666666669999999999999999
99999999999999666666669999999999999999999999999966996669964469999966996999999980888899999999996666666446664444466699999996699996999668888900896699666699999964462466666666666666666666699999999999999999
99999999999999666666666966999999999999989999999989999999666664464444646669888880888899999899966466466999999999966669966999988666666999800886989999666999998642226666666666666666666666999999999999999999
99999999999999999996666699999996969966999999999999999996666999969944464699998080000996966669996666996666699999996669999999999996699998080000089999666699999424499666666666666666999999999999999999999999
99999999999999999999996669965233669999999996699666669966669999669999666669980088899899999966694649996664444666999999996999999999666669668880988966666999999225696666666666666669999999999999999999999999
99999999999999999999999969999432299996999999666699669966699999699999699988889980899889966666664449999966666669999966999996696696698886698980898999999966996253566666666669999999999999999999999999999999
99999999999999999999999966999425399999966999999999999966988896669999699666669969988989669999464456999999699999996999699999966999996986998998996666699999998433666666666999999999999999999999999999999999
99999999999999999999999996699522499999996999999999999698889989899669999699666999988888996696444444966669999999669666999999999989966696696669996666699999999999666666669999999999999999999999999999999999
99999999999999999999999996996556999969966696999999996698089800886699966696666966999889644664644449999966999964666699666669996999666669996699996666999999969666656666699999999999999999999966666699999999
99999999999999999999999996699999999969999999999996669800000880089966966666666696669996699964569999999969999664699666696696999999669998898999996966899999999645259666696999999999999999999996666999999999
99999999996699999999999999696699966999999999969966699698888880096666669999996669669999699964669666698999996646699666466669699966699888988996989999999999996645246666699999999999999999966666669999999999
99999999966669999999999999669964666969999999666669999699988808896666666666666996666699669966469996666669999699999669964466699699998086999999669899999996666644666666999999999999999996666666999999999999
99999999966666699999999999996996246696969699889966666669889989999996699966999964666998699994449969996669996699996669966666666999988989808888899999999969966999666666999999999999999666666669999999999999
99999999999666666999999999999999646999669966999996969899966469999999699996969966696998969964469999999666999969999689999666444988988800998896696999999699996966666666999999999999999666666999999999999999
99999999999999996669999999999999666699999966999999969999646666998899988889966666696998966964646999964666664666999999999966664498889800888896446699999999999966666666666699999999999966669999999999999999
99999999999999996699999999999999666666988999699998996996669999998889989989996666669896666664664649646464646969999969969994444988899808896698646669999899969966666666666699999999999966699999999999999999
99999999999999999999999999999996666669999966669699999666444699800088999999966669698666966666464444466666469969969669999666644466666988944664446666999999999966666666666699999999999999999999999999999999
99999999999999999999999999999999666699666666966669999664449888808000899999969999669666966966644466669666699969969669996699966666666669996444669666999699999966666666666699999999999999999999999999999999
99999999999999999999999999999996966996699696669699996944446669980080896696699689666666669969996446666669996999899999666998999664444646969644996696999899699966666666666999999999999999999999999999999999
99999999999999999999999999969666699666666986666999996644469988880080899999644469966666699669899666666966566968999999969968966666969669964446996688998999969966666666669999999999999999999999999999999999
99999999966666699999999996996669966999666666666998996666444444466680899996666969666699999666696664666664469999699999996696999989996999896699669699698889969966666666669999999999999999999999999999999999
99999999666666666699999999669669669999999999666999966999666644466498894646666996668666666966699664646669996996999989996998996699996688899996666699969908999666666666999999999999999999999999999999999999
99999999666666666666669969999699699899889999999994466699966666666498996446666666669998899966699669644469999996669888889999666999964699999669966999999998996666666669999999999999999999999999999999999999
99999999996666666696666666999699999999999999999666699666666999988989989666666966699999699966666666666669999999999966499999999696444446446664446999999999966666666999999999999999999999999999999999999999
99999999999966666666666666999669999666999999996964669998998969896668896996699666999996699999999969699999999999996255545999999996696466444496669998999999666666699999999999999999999999999999999999999999
99999999999999966666666666999964999969999669994444466666698889999998696664446669966964699989999999999999996233222552224999999999999999999999899999669999666669999999999999999999999999999999999999999999
99999999999999999666666666666962269669999999999444444666669889698999999644446666966966699889999969999999992654664532445999996999999999999999998896699966666999999999999999999999999999999999999999999999
99999999999999999666666969996642369699999999669966666999999988888969999666666669989666699999666699969666699996252555226999999999999999999999996999999666669999999999999999999999999999999999999999999999
99999999999999666666666666966456699999999999999996999998669880000898999699999996696666699996666699966996694524662322225969999899999998999999999999966666669999999999999999999999999999999996699999999999
99999999999966666666669999666669999999999999966999999969988000800888899899999996644699999999666669999666999998953332332699999999999989999996998996666666699999999999999999999999999999999999999999999999
99999999996666666666964566666999999999999999999969999666669899899999999989966664469999999899666669989996499452224335933599964666699889699998999666666666999999999999999999999999999999999999999999999999
99999999966666666669435644669999999999996666696699998999669944999669644444696696669999999999699969999996543332699999666433269666569666999999966666666699999999999999999999999999999999999999999999999999
99999999966666666669625566999699996666666666669966999999664444499966666666999996666999999999969999999699554326999999696666469999999999999996666666666999999999999999999999999999999999999999999999999999
99999999966666666666666988966699999666666666699696699999999644446444699996999999999966999699999999999942699656999999996666999999999999966666666666669999999999999999999999999999999999999999999999999999
99999999966666666459999889996666996666666666996996696999999966666996999999999999999999999969996669994559969999999999999666996666999999999666666696699999999999999999999999999999999999999999669999999999
99999999966666666699999999996966999999666669999996666669999999999999996999999999996699999999999999642499999966666666999666996666669999999999999999999999999999999999999999999999999999999999666999999999
99999999996666669999999999999966699888989999999996666969996999999999699999999999999666999669652232224999999966966666666699666699999999999999999999999999999999999999999999999999999999999996666999999999
99999999999966669669999999899966669999999966999999999999999989666666999966696699996699666445696696469999999666666666666666999999999999999999999999999999999999999999999999999999999999999999666999999999
99999999999999996699999999896666699999966669969969999999966966666964464553269999969662222259966669999999999666666666666666999999999999999999999999999999999999999999999999999999999999999996669999999999
99999999999999999336999699999998899996666669996999989999966666999966656622232499433333666669666669999996999966666666666669999999999999999999999999999999999999999999999999999999999999999999999999999999
99999999999999996244552696999988889966666699999998999699969999966469946232233312222255699666669999999999999666666666699999999999999999999999999999999999999999999999999999999999999999999999999999999999
99999999999999999642466599998998899999999999669999999999696969966969426923323352456696999666999999999999999966969999999999999999999999999999999999999999999999999999999999999999999999999999999999999999
99999999999999999966462699699888999988999996666999999999886232222252346862333265669999999999999999999999999999999999999999999999999999999999999999999999999999999999999999999999999999999999999999999999
99999999999999999666636966666980089899996666899969966998635996533322264992333329999999999999999999999999999999999999999999999999999999999999999999999999999999999999999999999999999999999999646999999999
99999999999999999642369966998889669666666698899999966994669666655522522332254699966999999999999999999999999999999999999999999999999999999999999999999999999999999999999999999999999999999966655469999999
99999999999999999633249996999966666666666669899966669669666669966666666666666999999999999999999999999999999999999999999999999999999999999999999999999999999999999999999999999999996699996522266556999999
99999999999999999996655669966669666554444662696699999966666666999966666696999999999999999999999999999999999999999999999999999999999999999999999999999999999999999999999999999999965469642444455699999999
99999999999999999999994355224999999999999999444699999999969666999999999999999999999999999999999999999999999999999999999999999999999999999999999999999999999999999999999999999999999964254444524699999999
99999999999999999999999669999999999999999999999999999999999999999999999999999999999999999999999999999999999999999999999999999999999999999999999999999999999999999999999999999999999422444445569999999999
99999999999999999999999999999999999999999999999999999999999999999999999999999999999999999999999999999999999999999999999999999999999999999999999999999999999999999999999999999999968424444556996469999999
99999999999999999999999999999999999999999999999999999999999999999999999999999999999999999999999999999999999999999999999999999999999999999999999999999999999999999999999999999999645495225699964546999999
99999999999999999999999999999999999999999999999999999999999999999999999999999999999999999999999999999999999999999999999999999999999999999999999999999999999999999999999999999999644454966999969699999999
99999999999999999999999999999999999999999999999999999999999999999999999999999999999999999999999999999999999999999999999999999999999999999999999999999999999999999999999999999996444446999999999999999999
99999999999999999999999999999999999999999999999999999999999999999999999999999999999999999999999999999999999999999999999999999999999999999999999999999999999999999999999999999996699999999999999999999999
99999999999999999999999999999999999999999999999999999999999999999999999999999999999999999999999999999999999999999999999999999999999999999999999999999999999999999999999999999999999999999999999999999999
99999999999999999999999999999999999999999999999999999999999999999999999999999999999999999999999999999999999999999999999999999999999999999999999999999999999999999999999999999999999999999999999999999999
99999999999999999999999999999999999999999999999999999999999999999999999999999999999999999999999999999999999999999999999999999999999999999999999999999999999999999999999999999999999999999999999999999999
